|================|
|==###===========|
|==#X#===========|
|==# ####========|
|###O OX#========|
|#X O@###========|
|####O#==========|
|===#X#==========|
|===###==========|
|================|
|================|
|================|
|================|
|================|
||===============|
