|================|
|==######========|
|==#    #========|
|###OOO #========|
|#@ OXX #========|
|# OXXX##========|
|####  #=========|
|===####=========|
|================|
|================|
|================|
|================|
|================|
|================|
||===============|
