|================|
|=####==#####====|
|##  #==#   #====|
|# O ####O  #====|
|#  OXXXX O #====|
|##    # @ ##====|
|=##########=====|
|================|
|================|
|================|
|================|
|================|
|================|
|================|
||===============|
