|================|
|=######=========|
|##    ##========|
|# O OO #========|
|#XXXXXX#========|
|# OO O #========|
|### @###========|
|==####==========|
|================|
|================|
|================|
|================|
|================|
|================|
||===============|
