|================|
|==########======|
|==#    ###======|
|==# O    #======|
|### O ## #======|
|#XXX O   #======|
|#XXXO#O ##======|
|#### # O #======|
|===#   @ #======|
|===#######======|
|================|
|================|
|================|
|================|
||===============|
