|================|
|=#######========|
|=#XXXX #========|
|###XXXO###======|
|#  O#O O #======|
|# OO  #O #======|
|#    #   #======|
|#### @ ###======|
|===#####========|
|================|
|================|
|================|
|================|
|================|
||===============|
