|================|
|==#####=========|
|###   ####======|
|#   O  O #======|
|# O @O   #======|
|###OO#####======|
|==#  XX#========|
|==#XXXX#========|
|==######========|
|================|
|================|
|================|
|================|
|================|
||===============|
