|================|
|######===#####==|
|#    ###=#  X#==|
|#  O O #=#XXX#==|
|# #  O ###  X#==|
|#  OOO   O @X#==|
|###  O  O#  X#==|
|==#  O#O #XXX#==|
|==##     #  X#==|
|===###########==|
|================|
|================|
|================|
|================|
||===============|
