|================|
|########========|
|#XXXXXX#========|
|#  O # ##=======|
|# O # O #=======|
|##O O O #=======|
|=#  @   #=======|
|=########=======|
|================|
|================|
|================|
|================|
|================|
|================|
||===============|
