|================|
|=#######========|
|=#     ###======|
|##O###   #======|
|# @ O  O #======|
|# XX# O ##======|
|##XX#   #=======|
|=########=======|
|================|
|================|
|================|
|================|
|================|
|================|
||===============|
