|================|
|====######======|
|==###    ###====|
|==#   #O   ###==|
|==#   O   OO #==|
|==# OO #O    #==|
|==##   O   O #==|
|###### #O#####==|
|#XX@ #O  #======|
|#X#XX  O##======|
|#XXXXO# #=======|
|#XXXX   #=======|
|#########=======|
|================|
||===============|
