|================|
|###############=|
|#      #      #=|
|# O #O # O##O #=|
|# #  O #      #=|
|#   ##O#O##OO #=|
|# # # XXX #   #=|
|# O  X # XO   #=|
|# O#@OXXX# #  #=|
|#    X # X  O #=|
|# ##XO###OX # #=|
|# # OXXXXX ## #=|
|#             #=|
|###############=|
||===============|
