|================|
|#########=======|
|#   ##  #=======|
|# # O O #=======|
|#  QX#  #=======|
|## #X@X##=======|
|##O###Q###======|
|#        #======|
|#   ## # #======|
|######   #======|
|=====#####======|
|================|
|================|
|================|
||===============|
