|================|
|=#####==========|
|=# @###=========|
|=# O  #=========|
|### # ##========|
|#X# #  #========|
|#XO  # #========|
|#X   O #========|
|########========|
|================|
|================|
|================|
|================|
|================|
||===============|
