|================|
|===#######======|
|####     #======|
|#   X### #======|
|# # #    ##=====|
|# # O O#X #=====|
|# #  Q  # #=====|
|# X#O O # #=====|
|##    # # ###===|
|=# ###X    @#===|
|=#     ##   #===|
|=############===|
|================|
|================|
||===============|
