|================|
|===#######======|
|==##  # @#======|
|==#   #O #======|
|==#O  O  #======|
|==# O##  #======|
|### O # ##======|
|#XXXXX  #=======|
|#########=======|
|================|
|================|
|================|
|================|
|================|
||===============|
