|================|
|==#####=========|
|###  @#=========|
|#  OX ##========|
|#  XOX #========|
|### QO #========|
|==#   ##========|
|==######========|
|================|
|================|
|================|
|================|
|================|
|================|
||===============|
