|================|
|==####==========|
|==#XX#==========|
|=## X##=========|
|=#  OX#=========|
|## O  ##========|
|#  #OO #========|
|#  @   #========|
|########========|
|================|
|================|
|================|
|================|
|================|
||===============|
