|================|
|########========|
|#  #   #========|
|# OXXO #========|
|#@OXQ ##========|
|# OXXO #========|
|#  #   #========|
|########========|
|================|
|================|
|================|
|================|
|================|
|================|
||===============|
