|================|
|######==========|
|#    #==========|
|# OOO##=========|
|#  #XX###=======|
|##  XXO #=======|
|=#  @   #=======|
|=########=======|
|================|
|================|
|================|
|================|
|================|
|================|
||===============|
