|================|
|#####===========|
|#@  #===========|
|# OO#=###=======|
|# O #=#X#=======|
|### ###X#=======|
|=##    X#=======|
|=#   #  #=======|
|=#   ####=======|
|=#####==========|
|================|
|================|
|================|
|================|
||===============|
