|================|
|#######=========|
|#XXOXX#=========|
|#XX#XX#=========|
|# OOO #=========|
|#  O  #=========|
|# OOO #=========|
|#  #@ #=========|
|#######=========|
|================|
|================|
|================|
|================|
|================|
||===============|
