|================|
|===######=======|
|===# XXX#=======|
|####XXXX#=======|
|#  ###O ###=====|
|# O O  OO #=====|
|#@ O O    #=====|
|#   ###   #=====|
|#####=#####=====|
|================|
|================|
|================|
|================|
|================|
||===============|
