|================|
|=====######=====|
|=#####X   #=====|
|=#  #XX## #=====|
|=#  OXX   #=====|
|=#  # X# ##=====|
|### ##O#  #=====|
|# O    OO #=====|
|# #O#  #  #=====|
|#@  #######=====|
|#####===========|
|================|
|================|
|================|
||===============|
