|================|
|=#########======|
|=#   ##  ####===|
|=# O        #===|
|=##O### ##  #===|
|=#  ## Q # ##===|
|=# OXXXXXX #====|
|## ### X # #====|
|#     O###O#====|
|#   #    O@#====|
|#####O# ####====|
|====#   #=======|
|====#####=======|
|================|
||===============|
