|================|
|===######=======|
|####X  @#=======|
|#  OOO  #=======|
|#X##X##X#=======|
|#   O   #=======|
|#  OX# ##=======|
|####   #========|
|===#####========|
|================|
|================|
|================|
|================|
|================|
||===============|
