|================|
|=######=========|
|=#X XX#=========|
|=#X OX#=========|
|###  O##========|
|# O  O #========|
|# #O## #========|
|#   @  #========|
|########========|
|================|
|================|
|================|
|================|
|================|
||===============|
