|================|
|=####===========|
|##  #===========|
|#@O #===========|
|##O ##==========|
|## O #==========|
|#XO  #==========|
|#XXQX#==========|
|######==========|
|================|
|================|
|================|
|================|
|================|
||===============|
