|================|
|===######=======|
|=###    #=======|
|##X O## ##======|
|#XXO O @ #======|
|#XX O O ##======|
|######  #=======|
|=====####=======|
|================|
|================|
|================|
|================|
|================|
|================|
||===============|
